Sample_A1	AACT	ApeKI
Sample_B1	CCTA	ApeKI
Sample_C1	TTAC	ApeKI
Sample_D1	AGGC	ApeKI
Sample_E1	GCAT	ApeKI
Sample_F1	TAGA	ApeKI
Sample_G1	GTCA	ApeKI
Sample_H1	GATC	ApeKI
Sample_A2	CTGT	ApeKI
Sample_B2	AGAGA	ApeKI
Sample_C2	CGCGT	ApeKI
Sample_D2	TCTGA	ApeKI
Sample_E2	AACAT	ApeKI
Sample_F2	CCACA	ApeKI
Sample_G2	TTGTT	ApeKI
Sample_H2	GATGT	ApeKI
Sample_A3	CGTAA	ApeKI
Sample_B3	ACATT	ApeKI
Sample_C3	TTCCA	ApeKI
Sample_D3	GTGGA	ApeKI
Sample_E3	AGTCT	ApeKI
Sample_F3	CACTA	ApeKI
Sample_G3	TGAAT	ApeKI
Sample_H3	GCGAT	ApeKI
Sample_A4	AAGCA	ApeKI
Sample_B4	CTAGC	ApeKI
Sample_C4	TCCTC	ApeKI
Sample_D4	GTACT	ApeKI
Sample_E4	GGTTC	ApeKI
Sample_F4	ACGGC	ApeKI
Sample_G4	CACAGT	ApeKI
Sample_H4	TCTGGA	ApeKI
Sample_A5	AGACGT	ApeKI
Sample_B5	CATTGA	ApeKI
Sample_C5	TTCAGA	ApeKI
Sample_D5	GCAGGT	ApeKI
Sample_E5	TGGCGA	ApeKI
Sample_F5	ATCGGT	ApeKI
Sample_G5	CAGTAT	ApeKI
Sample_H5	CGTATA	ApeKI
Sample_A6	GAGCGT	ApeKI
Sample_B6	ACATGA	ApeKI
Sample_C6	TGCAAT	ApeKI
Sample_D6	CTTGAA	ApeKI
Sample_E6	GACATA	ApeKI
Sample_F6	ACTAGT	ApeKI
Sample_G6	GTACAA	ApeKI
Sample_H6	ACGGTT	ApeKI
Sample_A7	GGCTGA	ApeKI
Sample_B7	CAAGTT	ApeKI
Sample_C7	TGTTCA	ApeKI
Sample_D7	TTGCAGA	ApeKI
Sample_E7	AACAGGT	ApeKI
Sample_F7	CCACTGA	ApeKI
Sample_G7	CTTGAGT	ApeKI
Sample_H7	TGCTGGA	ApeKI
Sample_A8	GAGCAGT	ApeKI
Sample_B8	ACAACGT	ApeKI
Sample_C8	CTGGTGA	ApeKI
Sample_D8	GCTTGGA	ApeKI
Sample_E8	TGACAGT	ApeKI
Sample_F8	AACGTGA	ApeKI
Sample_G8	TTGACGT	ApeKI
Sample_H8	CATTGGT	ApeKI
Sample_A9	GGCCTGA	ApeKI
Sample_B9	ACTAAGA	ApeKI
Sample_C9	TTAGCTT	ApeKI
Sample_D9	CGGTGAA	ApeKI
Sample_E9	GAATCGT	ApeKI
Sample_F9	ACCAGTA	ApeKI
Sample_G9	TTGCTAT	ApeKI
Sample_H9	GGTGAGC	ApeKI
Sample_A10	AACAATGA	ApeKI
Sample_B10	CCACCGGT	ApeKI
Sample_C10	CTTGTAGT	ApeKI
Sample_D10	TCGTGTGA	ApeKI
Sample_E10	GGAACGGT	ApeKI
Sample_F10	AATCAAGA	ApeKI
Sample_G10	TTCGTTGA	ApeKI
Sample_H10	CGGTGAGT	ApeKI
Sample_A11	GAATCGGA	ApeKI
Sample_B11	ACCATTGT	ApeKI
Sample_C11	TTGCAGGA	ApeKI
Sample_D11	GCTGGAGT	ApeKI
Sample_E11	AGACCTTA	ApeKI
Sample_F11	CACAAGAT	ApeKI
Sample_G11	TGTTGCGA	ApeKI
Sample_H11	CTGGTTAT	ApeKI
Sample_A12	GAACAATA	ApeKI
Sample_B12	ACCACGCT	ApeKI
Sample_C12	GTTGTCGA	ApeKI
Sample_D12	TCGTGATT	ApeKI
Sample_E12	AGACTTAT	ApeKI
Sample_F12	CACTCCGA	ApeKI
Sample_G12	TTGAAGCT	ApeKI
Sample_H12	GGTGGCAA	ApeKI

